1111111111
111EP00C01
1111111111