1111111111111
10001000111C1
1P10001010001
101111E000111
1111111111111