11111111111111111111
1P0C1C001C0C1000C1C1
10111101110110111101
100C00C000C00C000C01
10111111111111111111
10C0001000C00C100C01
111101101111101111C1
1110001C00C00010C001
101110111011101111C1
10C0100C000C00C00C01
10101011110111011101
1000100C01000001C0C1
10111011010111011111
10C0001C010C01000001
10111111111111111101
1000000000000010C001
10111110111110111101
1000C010C0C0C01C0001
10111111110110111101
1C000C0C100C1C0001E1
11111111111111111111